5 5
4 0 3 0 5
0 0 0 0 0
2 7 0 0 0
0 0 0 0 0
1 0 0 0 2